[][][][][][][][][][][][][][][][][][][][][][][][][][]
[]                                                []
[]                zs                              []
[]                                    []          []
[][]    [][][][][][][][][]  [][][][][][]          []
[]          []                        []          []
[]          []        zs              []          []
[]          []                        []          []
[][]    [][][][][][][][]      [][][][][]          []
[]                []                  []          []
[]      ps        []                  []          []
[]                []                  []          []
[][][][][]    [][][][][][][]    [][][][]          []
[]                                    []          []
[]                                                []
[]                                                []
[][][][][][][][][][][][][][][][][][][][][][][][][][]
